12 17
.###..###.S###..#
#.###.###.###.###
.###..###..###..#
#.###.###.###.###
.###..###..###..#
#.###.###.###.###
.###..###..###..#
#.###.###.###.###
#.........###....
..#.###......####
..E#.#..#...#....
#################
